0,2,0,3,1,30,1500,5,20
0,5,0,3,1,30,1500,5,20
0,10,0,3,1,30,1500,5,20
0,12,0,3,1,30,1500,5,20
0,15,0,3,1,30,1500,5,20
0,16,0,3,1,30,1500,5,20
0,17,0,3,1,30,1500,5,20
