0,4,0,3,1,30,1500,5,20
1,6,0,5,2,200,1000,5,10
1,11,0,5,2,200,1000,5,10
1,11,0,5,2,200,1000,5,10
0,10,0,3,1,30,1500,5,20
0,15,0,3,1,30,1500,5,20
0,16,0,3,1,30,1500,5,20
0,16,0,3,1,30,1500,5,20
1,19,0,5,2,200,1000,5,10