0,1,0,3,1,30,1500,5,20
0,1,0,3,1,30,1500,5,20
0,3,0,3,1,30,1500,5,20
0,4,0,3,1,30,1500,5,20
1,5,0,5,2,200,1000,5,10
1,7,0,5,2,200,1000,5,10
0,8,0,3,1,30,1500,5,20
1,11,0,5,2,200,1000,5,10
0,13,0,3,1,30,1500,5,20
0,14,0,3,1,30,1500,5,20
1,17,0,5,2,200,1000,5,10
1,17,0,5,2,200,1000,5,10
1,19,0,5,2,200,1000,5,10
0,22,0,3,1,30,1500,5,20
0,22,0,3,1,30,1500,5,20
0,22,0,3,1,30,1500,5,20